9 8 80
---------
---------
--=-#-=--
--=###=--
=-#-#-#-=
----=----
---------
---------